################
#        #    E#
#        #     #
#        #     #
#        #     #
#              #
#           #  #
#    ##     #  #
#    #      #  #
#    #      #  #
#P   #  #   #   #
################